8-5
...TT...
.O.TT..C
....T..T
..@..S.C
C....S..
